булка	еда
колбаса	еда
сухарики	еда
курица	еда
тапки	одежда
шапка	одежда
куртка	одежда
сапоги	одежда
ведро	быт
мыло	быт
мочалка	быт
швабра	быт
акции	финансы
облигации	финансы
золото	финансы
монетки	финансы
текила	питье
пиво	питье
кола	питье
минералка	питье
хагиваги	игрушка
мячик	игрушка
кукла	игрушка
лего	игрушка
